..................................
..................................
..................................
................X.................
..................................
..........##############..........
..................................
.....##....................##.....
..................................
..................................
.---..........................---.
..................................
..................................
......####.............####.......
.............---.---..............
..................................
..................................
..................................
........#####.......#####.........
..................................
..###.......................###...
................1.................
##################################
..................................
..................................
..................................